NO textures/wall_north.xpm
SO textures/wall_south.xpm
WE textures/wall_base.xpm
EA textures/wall_base.xpm

F textures/floor.xpm
C textures/ceiling.xpm

DL textures/door_red.xpm
DU textures/door_green_locked.xpm
DO textures/door_green_unlocked.xpm
LON textures/lever_off_north.xpm
LOS textures/lever_off_south.xpm
LOB textures/lever_off_base.xpm
LNN textures/lever_on_north.xpm
LNS textures/lever_on_south.xpm
LNB textures/lever_on_base.xpm

11111D1L111
10000000001
10000000001
10000000001
10000000001
1000000N001
11111111111